                             DANGER NOODLE                                    
  ##################################################################          
  ##                                                            ####          
  ##                                                              ##          
  ##                                                              ##          
  ##                                                              ##          
  ##                                                              ##          
  ##                                                              ##          
  ##                                                              ##          
  ##                                                              ##          
  ##                                                              ##          
  ##                                                              ##          
  ##                                                              ##          
  ##                                                              ##          
  ##                                                              ##          
  ##                                                              ##          
  ##                                                              ##          
  ##                                                              ##          
  ##                                                              ##          
  ##                                                              ##          
  ##                                                              ##          
  ##                                                              ##          
  ##################################################################          
            SCORE:                           LEVEL:                           
